R 1920 1080
NO ./textures/NO.xpm
SO ./textures/SO.xpm
WE ./textures/WE.xpm
EA ./textures/EA.xpm

S ./textures/ITEM.xpm
F 220,100,0
C 225,30,0

   1111111111111111111111111
   1000000000110000000000001
   1011000200110000000000001
   10010000000000N0000000001
1111111110110000011100000001
1000000000110000011101111111
1111111111111111111111
