R 1080 640

NO ./textures/NO.xpm
SO ./textures/SO.xpm
WE ./textures/WE.xpm
EA ./textures/EA.xpm

S ./textures/ITEM.xpm
F 25,229,134
C 0,181,242

1111111111111
1N000001
11111111

1111111111111
1100000000001
1111111111111
