R 700 700
NO ./textures/NO.xpm
SO ./textures/SO.xpm
WE ./textures/WE.xpm
EA ./textures/EA.xpm

S ./textures/ITEM.xpm
F 25,229,134
C 0,181,242

11111111111
10000000001
10000000001
1000S000001
10000000001
10000000001
10000010001
10000000001
10000000001
10000000001
11111111111
11111111111
11111111111
