R 1080 600

NO ./textures/NO.xpm
SO ./textures/SO.xpm
WE ./textures/WE.xpm
EA ./textures/EA.xpm

S ./textures/ITEM.xpm
F 25,229,134
C 0,181,235

1111111111111
1N000001
10000001
1111111

11111111111
1000000000011
1100000000001
1111111111111
