R 900 400
NO ./textures/NO.xpm
SO ./textures/SO.xpm
WE ./textures/WE.xpm
EA ./textures/EA.xpm

S ./textures/ITEM.xpm
F 220,100,0
C 225,30,0

   1111111111111111111111111
   1000000000110000000000001
   1011000200110000000000001
   1001000000000000000000001
1111111110110000011100000001
1000000000110000011101111111
1111100111110000011111
111110011111000N011111
1111100111110000011111
1111111111111111111111
